1111111111111
1P000011000E1
1011101111011
1C0010M0000C1
1110111011101
1M000C00000M1
1111111111111
