11111
1P1C1
1C111
1E001
11111
